1111111111111111111111111111111111111111
1111110000000111111111111000000011111111
1111110C1111001111111111110C111100111111
1100C00000C0000C00111100C00000C0000C0011
1100000000000000000000000000000000000011
110C00C00000C000C011110C00C00000C000C011
1100C1001111001000111100C100111100100011
1111110011110011101111111100111100111011
1111110011110011111111111100111100111P11
1111111111110111111111111101111111111111
1111111111110111111111111101111111111111
11111100000001111111111111010100E1111111
1111110C1111001111111111100C011100111111
1100C00000C0000C00111100C00000C0000C0011
1100000000000000001111000000000000000011
110C00C00000C000C000000C00C00000C000C011
1100C1001111001000111100C100111100100011
1111110011110011101111111100111100111011
1111110011110011111111111001111001111111
1111111111111111111111111111111111111111