1111111111
100PCXE001
1111111111