1111111111
100P00E001
1111111111