1111111111111111111
1000010001C00000001
1C00E00P01C00000001
1C00000001C00000001
1C00000001C00000001
1C00000001C00C01001
1C00000001C00C01001
1C00000001C00C01001
1C00000001C00C01001
1C00000001C00C01001
1111111111111111111