1111111111
1000C00001
000P00E001
1111111111