11111111111
10P0E00C011
100000000111
11111111111