11111111
101000C1
1C100001
101000E1
101000P1
11111111