1111111111
1000C00001
100P00E001
1111011111