11111111111111111111
1111110000000E111111
1111110C111100111111
1100C00000C0000C0011
11000000000000000011
110C00C00000C000C011
1100C100111100100011
11111100111100111011
11111100111100111P11
11111111111111111111